 1 1 1 1 1 1 1 1 1 1 1
 1 1 1 1 1 1 1 1 1 1 1
 1 1 1 1 1 1 1 1 1 1 1
 1 1 1 1 1 1 1 1 1 1 1
 1 1 1 1 1 1 1 1 1 1 1
 1 1 1 1 1 1 1 1 1 1 1
 1 1 1 1 1 1 1 1 1 1 1
 1 1 1 1 1 1 1 1 1 1 1
 1 1 1 1 1 1 1 1 1 1 1
 1 1 1 1 1 1 1 1 1 1 1
 1 1 1 1 1 1 1 1 1 1 1

S 391 F 323
 0 0 0 0 0 0 0 0 0 0 0
 0 0 0 0 0 0 0 0 0 0 0
 0 0 0 0 0 0 0 0 1 0 0
 0 0 0 0 0 0 0 0 0 0 0
 0 0 0 0 0 0 0 0 0 0 0
 0 0 0 0 0 0 0 0 0 0 0
 0 0 0 0 0 0 0 0 0 0 0
 0 0 0 0 0 0 0 0 0 0 0
 0 0 0 0 0 0 0 0 0 0 0
 0 0 0 0 0 0 0 0 0 0 0
 0 0 0 0 0 0 0 0 0 0 0

 100 156 206 250 288 287 286 285 284 283 282
 157 207 251 289 321 320 319 318 317 316 281
 208 252 290 322 348 347 346 345 344 315 280
 253 291 323 349 369 368 367 366 343 314 279
 292 324 350 370 384 383 382 365 342 313 278
 325 351 371 385 392 391 381 364 341 312 277
 352 372 386 393 396 390 380 363 340 311 276
 353 373 387 394 395 379 362 339 310 275 234
 354 374 388 389 378 361 338 309 274 233 186
 355 375 376 377 360 337 308 273 232 185 132
 356 357 358 359 336 307 272 231 184 131 72

 391 392 384 370 349 323
